R 1920 1080
NO ./textures/wood.xpm
WE  ./textures/brick.xpm
SO  ./textures/stone.xpm
EA  ./textures/metal.xpm
S ./textures/barrel.xpm
C 2,222  ,233
F 111,1,113

       1111111111111111111111111
111     1000000000100000000000001
101     1011000000000000000000001
111     1001000000000000000000001
111111111011000000000000000000001
1000000000110000000000000000001111
1111011111110000000000000000001
1111011111000000222222222222001
1100000000000000000000000000001
1000020000000000000000000000001
1000000000000000N00000000000111
110000000000000000000000000011111111111111111111111111
100000000000000000000000000000001111111111111111111111111
111111111111111100011111001111111111111111111111111111111111111
              1000001 100001
              1000001 100001
              1100001 100001
              1111111 111111